level5
####################
#o#       #    o   #
#   @     #      ###
#       #####   @  #
#  o   @  o        #
#            @ A   #
#    @            o#
#                  #
#       ######     #
#       ######     #
#     @    o       #
#                  #
#                  #
#                  #
#                  #
####################