level3
#######
###   #
###   #
### @o#
###   #
#     #
#A@o  #
#######